1111111111111111
1P00000000000001
1000000000000001
1000000000000001
10C0C0C0C0C0C0C1
1000000000000001
1111000000000001
11111110000000E1
1111111111111111