1111111111111
10010000000C1
1000011111101
1P0011E000001
1000C0C0C0001
1000DD0000001
1010000100001
10000D0010001
1111111111111