1111111111111111111111111111
1000000000000000000000000001
1000000000000000000000000001
1000000000000000000000000001
1000000000000000000000000001
1000000000E00000001111000001
1000101110000000000000000001
1000100011110000000000000001
1000100000000000011111000001
1000100000000000000000001111
1000100000000000000000000001
100010000C0000000000P0000001
1000100000000000000000000001
1111111111111111111111111111