1111111111
1PCCCCCCC1
10000000C1
10CCCCC0C1
10C000C0C1
10C0E0C0C1
10C0CCC0C1
10C00000C1
10CCCCCCC1
1111111111