1111111111111
1PP1PPPPPPPC1
1000011111101
1P0011E000001
1000C0C0C0001
1000DD0000001
101PPPP100001
10000D0010001
1111111111111