1111111111111111
10P0000000000001
100000000C000001
10000EE000000001
1111111111111111