1111111111111111
10P0000000000001
1000000000E00001
1111111111111111
1CCCCCCCCCCCCCC1
1111111111111111